abilcmd              id : a    size : 4
actor                id : i    size : 4
actorscope           id : e    size : 4
aifilter             id : j    size : 4
animtarget           id : n    size : 4
bank                 id : b    size : 4
bool                 id : ?    size : 1
byte                 id : 1    size : 1
camerainfo           id : c    size : 4
char                 id : '    size : 1
color                id : 2    size : 4
doodad               id : M    size : 4
fixed                id : 3    size : 4
handle               id : h    size : 4
int                  id : 4    size : 4
marker               id : m    size : 4
order                id : o    size : 4
playergroup          id : l    size : 4
point                id : p    size : 4
region               id : r    size : 4
revealer             id : R    size : 4
sound                id : S    size : 4
soundlink            id : d    size : 4
string               id : s    size : 4
text                 id : x    size : 4
timer                id : t    size : 4
transmissionsource   id : y    size : 4
trigger              id : T    size : 4
unit                 id : U    size : 4
unitfilter           id : f    size : 4
unitgroup            id : u    size : 4
unitref              id : v    size : 4
wave                 id : W    size : 4
waveinfo             id : w    size : 4
wavetarget           id : g    size : 4
